LAYER 0
10101000
11111000
00000000
11111000
10001111
00100111
00100111
11111111

LAYER 1
00000000
00100000
00000000
00000000
00000000
00000000
00000100
01110100

LAYER 2
00000000
00100000
00000000
00000000
00000000
00000000
00000001
01010100

LAYER 3
00000000
00100000
00000000
00000000
00000000
00000000
00000000
01100001