Layer 0
1010100000000000
1111100000000000
0000000000000000
1111100000000000
1000111100001111
0010011100000111
0010011100000011
1111111100000001

Layer 1
0000000000000000
0000000000000000
0000000000000000
0000000000000000
0000000000000111
0000000000000011
0000000000000001
0000000000000000

Layer 2
0000000000000000
0000000000000000
0000000000000000
0000000000000000
0000000000000011
0000000000000001
0000000000000000
0000000000000000

Layer 3
0000000000000000
0001000000000000
0001000000000000
0011100000000000
0000000000000001
0000000000000000
0000000000000000
0000000000000000